0110111000000000
0110111001101110
0110000001101110
0111111000001110
0111111001101110
0000011001100000
0111011001111110
0111000000001110
0111011001101110
0111011001101110
0000000001101110
