1011111111111111
1011111000000000
1011111011111111
1011111011111111
1011111011111111
1000000000000000
1110111111110111
0000111111110111
0110000000000111
0111111111110111
0111111111110111

